 ----------------------------
|                            |
|                            |
|                            |
|       WEB DEVELOPMENT      |
|                            |
|       🌐🌐🌐🌐🌐🌐          |
|                            |
|       NYU IDM              |
|                            |
|                            |
|                            |
|                            |
|                            |
|                            |
|                            |
|                            |
|                            |
 ----------------------------
